		char[][] map1 = new char [][] {
			{'I', 'O', 'O', 'O', 'O', 'O', 'O', 'O', 'O', 'O'},
			{'O', 'O', 'O', 'O', 'O', 'O', 'O', 'O', 'O', 'O'},
			{'O', 'O', 'O', 'O', 'O', 'O', 'O', 'O', 'O', 'O'},
			{'O', 'O', 'O', 'O', 'O', 'X', 'O', 'O', 'X', 'O'},
			{'O', 'O', 'O', 'X', 'O', 'O', 'O', 'O', 'O', 'O'},
			{'O', 'O', 'O', 'O', 'O', 'O', 'O', 'O', 'O', 'O'},
			{'O', 'O', 'X', 'X', 'O', 'X', 'O', 'O', 'O', 'O'},
			{'O', 'O', 'O', 'O', 'O', 'O', 'O', 'O', 'B', 'O'},
			{'O', 'O', 'O', 'O', 'O', 'O', 'O', 'O', 'O', 'O'},
			{'O', 'O', 'O', 'O', 'O', 'O', 'O', 'O', 'O', 'G'},
			};


		char[][] map2 = new char [][] {
			{'O', 'O', 'X', 'O', 'O', 'O', 'O', 'O', 'O', 'X'},
			{'O', 'X', 'O', 'X', 'O', 'O', 'B', 'O', 'O', 'X'},
			{'O', 'X', 'X', 'X', 'X', 'X', 'X', 'X', 'O', 'O'},
			{'O', 'O', 'O', 'O', 'O', 'O', 'O', 'O', 'O', 'O'},
			{'O', 'O', 'O', 'O', 'O', 'O', 'O', 'O', 'O', 'O'},
			{'O', 'O', 'O', 'X', 'X', 'X', 'X', 'O', 'O', 'O'},
			{'O', 'O', 'X', 'X', 'O', 'O', 'O', 'O', 'O', 'O'},
			{'O', 'O', 'O', 'X', 'O', 'O', 'O', 'O', 'O', 'O'},
			{'O', 'X', 'X', 'X', 'O', 'O', 'O', 'O', 'O', 'O'},
			{'G', 'O', 'I', 'O', 'O', 'O', 'O', 'O', 'O', 'O'},
			};


		char[][] map3 = new char [][] {
			{'O', 'O', 'O', 'O', 'O', 'O', 'O', 'O', 'O', 'O'},
			{'O', 'O', 'O', 'O', 'O', 'O', 'O', 'O', 'O', 'O'},
			{'O', 'O', 'O', 'O', 'O', 'O', 'X', 'O', 'O', 'O'},
			{'O', 'O', 'O', 'O', 'O', 'O', 'X', 'O', 'O', 'O'},
			{'O', 'I', 'O', 'O', 'O', 'X', 'X', 'O', 'B', 'O'},
			{'O', 'O', 'O', 'X', 'X', 'X', 'O', 'O', 'O', 'O'},
			{'O', 'O', 'O', 'O', 'O', 'X', 'O', 'O', 'O', 'O'},
			{'O', 'O', 'X', 'X', 'X', 'X', 'O', 'O', 'O', 'O'},
			{'O', 'O', 'O', 'O', 'G', 'O', 'O', 'O', 'O', 'O'},
			{'O', 'O', 'O', 'O', 'O', 'O', 'O', 'O', 'O', 'O'}
			};
			
		char[][] map4 = new char [][] {
			{'O', 'O', 'O', 'O', 'O', 'O', 'O', 'O', 'O', 'X'},
			{'O', 'O', 'O', 'O', 'O', 'O', 'O', 'O', 'X', 'O'},
			{'O', 'O', 'O', 'O', 'O', 'O', 'X', 'X', 'O', 'O'},
			{'O', 'O', 'O', 'O', 'O', 'O', 'X', 'O', 'O', 'O'},
			{'O', 'I', 'O', 'O', 'O', 'X', 'X', 'O', 'B', 'O'},
			{'O', 'O', 'O', 'X', 'X', 'X', 'O', 'X', 'X', 'O'},
			{'O', 'O', 'O', 'O', 'O', 'X', 'X', 'O', 'O', 'X'},
			{'O', 'O', 'X', 'X', 'X', 'X', 'O', 'O', 'O', 'O'},
			{'O', 'O', 'O', 'O', 'G', 'O', 'O', 'O', 'O', 'O'},
			{'O', 'O', 'O', 'O', 'O', 'O', 'O', 'O', 'O', 'O'}
			};
			
		char[][] map5 = new char [][] {
			{'O', 'O', 'O', 'O', 'O', 'O', 'O', 'O', 'O', 'O'},
			{'O', 'O', 'B', 'O', 'O', 'O', 'O', 'O', 'O', 'O'},
			{'O', 'O', 'O', 'O', 'O', 'O', 'X', 'O', 'O', 'O'},
			{'O', 'O', 'O', 'O', 'O', 'O', 'X', 'O', 'O', 'O'},
			{'O', 'O', 'O', 'O', 'O', 'X', 'X', 'O', 'O', 'O'},
			{'O', 'O', 'O', 'X', 'X', 'X', 'O', 'O', 'O', 'O'},
			{'O', 'O', 'O', 'O', 'O', 'X', 'X', 'O', 'O', 'X'},
			{'O', 'O', 'X', 'X', 'X', 'X', 'O', 'O', 'O', 'O'},
			{'O', 'X', 'O', 'O', 'G', 'O', 'X', 'O', 'I', 'O'},
			{'X', 'O', 'O', 'O', 'O', 'O', 'O', 'X', 'O', 'O'}
			};
		
		char[][] map6 = new char [][] {
			{'O', 'O', 'O', 'O', 'O', 'O', 'O', 'O', 'O', 'X'},
			{'O', 'O', 'B', 'O', 'O', 'X', 'X', 'O', 'O', 'O'},
			{'O', 'X', 'X', 'X', 'O', 'O', 'X', 'O', 'O', 'I'},
			{'O', 'X', 'X', 'X', 'O', 'O', 'X', 'X', 'O', 'O'},
			{'O', 'O', 'O', 'O', 'O', 'X', 'X', 'X', 'X', 'O'},
			{'X', 'O', 'O', 'X', 'X', 'X', 'X', 'O', 'O', 'O'},
			{'X', 'X', 'O', 'O', 'O', 'X', 'X', 'O', 'X', 'X'},
			{'O', 'O', 'O', 'X', 'X', 'X', 'O', 'X', 'O', 'X'},
			{'O', 'X', 'X', 'X', 'G', 'O', 'X', 'X', 'O', 'X'},
			{'O', 'O', 'O', 'O', 'O', 'O', 'O', 'X', 'O', 'O'}
			};